1111111111111
10000000000C1
10001111100M1
1PM011E000001
1111111111111