1111111111111111111111111111111111
1E0C000P0000000000M000000000000001
1010010100100000100001000000010101
101001001010101000M001000000010101
1101001001010101000100100000001011
1010010100100000101001000000010101
100000000000000001000000M000000001
1111111111111111111111111111111111