11111111111111111111111111111111111111111
1M0000000000000000000000000000000000000M1
100000000000100000E000M000000000000000001
100000000000100000M00000000000C0000000001
1000000000001000000000C000000000000000001
10000000000000000000000000000000000000001
1M0000000000000000000000000000P00000000M1
11111111111111111111111111111111111111111