111111111111111111111111111111111111111111
1P0000M000000000C0000000M00000000C00000001
100000001100001100000001111111111100000001
100C0000110C0011000M0001111111111100C00001
10000000110000110000000000000E111100M00001
1000M0001111111111100001111111111100000001
10000000111111111110000111100000000000C001
10000C000000001100000001111000000000000001
1000000000M0001100000001111111111100M00001
10000C00000000000C000000000000000000000001
111111111111111111111111111111111111111111