1111111111111111111111111111111111
1E00000M0000000C00000C00M000000001
10100101001000001010010000M0010101
1010010010101010001001000000010101
1P00M0000C00C000000M000000000000C1
1111111111111111111111111111111111