1111111111111111111111111111111111111111111
1P000000000M0000C0000000C00000000C000000001
1E00111110000011111000001111100000111110001
10001000100C0000001000000000100000100010001
100000001000000000100000000010000M000010001
10000MC010000011111000M01111100000000010001
1000000010000000001000000000100000000010001
10000C001000000000100M00000010000M000010001
1000000111000011111000001111100000000010001
10000C00000000000C0000000000000000000000001
1111111111111111111111111111111111111111111