1111111111111111111111111111111111
1E0C000P00000000000000000000000001
1010010100100000100001000000010101
1010010010101010000001000000010101
1101001001010101000100100000001011
1010010100100000101001000000010101
1000000000000000010000000000000001
1111111111111111111111111111111111