111111111111111111111111111111111111
1000000C000000000000C00000000C000001
100001100001100000001111111111100P01
100001100001100000001111111111100001
100001100001100000C0000000E111100001
100001111111111100001111111111100001
100001111111111100001111000000000001
100C00000001100000001111000000000001
100000000001100000001111111111100001
10C00000000000C000000000000000000001
111111111111111111111111111111111111