1111111111111111111111111111111111111111111
1P00000000000000C0000000C00000000C000000001
1E00111110000011111000001111100000111110001
100C1000100C0000001000000000100000100010001
1000000010000000001000000000100000000010001
1000000010000011111000001111100000000010001
1000000010000000001000000000100000000010001
1000000010000000001000000000100000000010001
1000000111000011111000001111100000000010001
10000C00000000000C0000000000000000000000001
1111111111111111111111111111111111111111111